1111111111
1ECP011001
1111111111
1000000001
1000000001
1111111111